9,5,5,5,5,5,5,5,10
2,38,37,38,36,38,38,37,1
2,42,62,63,48,45,41,55,1
2,42,40,53,43,54,40,47,1
2,42,49,44,55,52,41,44,1
2,47,40,56,57,46,40,45,1
2,51,41,60,61,41,41,54,1
2,58,59,50,41,55,62,63,1
0,6,6,6,6,6,6,6,0
