0,1,1,1,1,1,1,1,2
10,3,4,5,3,4,3,9,12
10,16,16,16,16,16,16,16,12
10,16,17,16,16,16,17,16,12
10,16,16,16,16,16,16,16,12
10,16,17,16,16,16,17,16,12
10,16,16,16,16,16,16,16,12
20,21,21,21,21,21,21,21,22
11,11,11,11,11,11,11,11,11
