9,5,5,5,5,5,5,5,5,10
2,32,32,32,32,32,32,32,32,1
2,41,41,41,41,41,41,41,41,1
2,41,41,41,41,41,41,41,41,1
2,41,41,3,6,6,4,41,41,1
2,41,41,7,5,5,8,41,41,1
2,41,41,32,32,32,32,41,41,1
2,41,41,41,41,41,41,41,41,1
2,41,41,41,41,41,41,41,41,1
0,6,6,6,6,6,6,6,6,0
