9,5,5,5,5,5,5,5,5,10
2,32,32,32,32,32,32,32,32,1
2,14,15,41,41,41,41,14,15,1
2,18,11,15,41,41,41,18,16,1
2,41,18,11,15,41,41,41,41,1
2,41,41,18,16,41,41,41,41,1
2,41,41,41,41,41,41,41,41,1
2,41,41,41,41,41,14,13,15,1
2,41,41,41,41,41,18,17,16,1
0,6,6,6,6,6,6,6,6,0
