9,5,5,5,5,5,5,5,5,10
2,32,32,32,32,32,32,32,32,1
2,41,41,41,41,41,41,41,41,1
2,41,41,41,41,41,41,41,41,1
2,41,41,14,13,12,15,41,41,1
2,41,41,20,11,11,19,41,41,1
2,41,41,18,17,17,16,41,41,1
2,41,41,41,41,41,41,41,41,1
2,41,41,41,41,41,41,41,41,1
0,6,6,6,6,6,6,6,6,0
