0,0,9,5,5,5,5,10,0,0
0,9,8,32,32,32,32,7,10,0
9,8,32,41,41,41,41,32,7,10
2,32,41,41,41,41,41,41,32,1
2,41,41,41,41,41,41,41,41,1
2,41,41,41,41,41,41,41,41,1
2,41,41,41,41,41,41,41,41,1
0,4,41,41,41,41,41,41,3,0
0,0,4,41,41,41,41,3,0,0
0,0,0,6,6,6,6,0,0,0
