0,0,9,5,5,5,10,0,0
0,9,8,32,32,32,7,10,0
9,8,32,14,13,15,32,7,10
2,32,14,11,11,11,15,32,1
2,14,11,11,11,11,11,15,1
2,11,17,17,17,17,17,11,1
2,19,41,41,41,41,41,20,1
2,16,41,41,41,41,41,18,1
2,41,41,41,41,41,41,41,1
2,41,41,41,41,41,41,41,1
2,13,15,41,41,41,14,12,1
2,11,19,41,40,41,20,11,1
2,11,19,41,41,41,20,11,1
0,6,6,6,6,6,6,6,0
