9,5,5,5,5,5,5,5,5,5,10
2,35,36,32,37,35,38,35,37,38,1
2,40,45,40,44,56,57,40,44,40,1
2,42,47,49,43,46,45,52,45,55,1
2,40,44,40,52,53,47,40,54,40,1
2,48,54,55,46,60,61,62,63,55,1
2,40,41,40,51,50,42,40,54,40,1
2,12,13,15,58,59,42,14,12,13,1
2,11,11,21,12,13,13,22,11,11,1
2,11,11,11,11,11,11,11,11,11,1
0,6,6,6,6,6,6,6,6,6,0
