0,1,1,1,1,1,1,1,1,2
10,3,4,5,6,7,8,4,9,12
10,16,16,16,16,16,16,16,16,12
10,16,16,16,16,16,16,16,16,12
10,16,16,16,16,16,16,16,16,12
10,16,16,16,16,16,16,16,16,12
10,16,16,16,16,16,16,16,16,12
10,16,16,16,16,16,16,16,16,12
10,16,16,16,16,16,16,16,16,12
20,21,21,21,21,21,21,21,21,22
