9,5,5,5,5,5,5,5,5,10
2,33,35,36,32,37,37,38,34,1
2,56,57,46,43,53,62,63,45,1
2,41,42,54,44,52,41,51,47,1
2,41,41,55,45,51,41,42,41,1
2,45,42,41,48,41,41,56,57,1
2,42,55,47,52,53,43,41,41,1
2,60,61,54,44,60,61,50,51,1
2,53,62,63,46,41,44,58,59,1
0,6,6,6,6,6,6,6,6,0
