9,5,5,5,5,5,5,5,10
2,32,32,32,32,32,32,32,1
2,12,13,12,13,12,12,12,1
2,17,17,17,17,17,11,11,1
2,41,41,41,41,41,20,11,1
2,41,41,41,41,41,20,11,1
2,41,41,41,41,41,20,11,1
2,41,41,41,41,41,20,11,1
0,6,6,6,6,6,6,6,0
