9,5,5,5,5,5,5,5,10
2,32,32,32,32,32,32,32,1
2,41,41,41,41,41,41,41,1
2,15,41,41,41,41,41,41,1
2,21,15,41,41,41,41,41,1
2,11,21,15,41,41,41,41,1
2,11,11,21,15,41,41,41,1
2,11,11,11,21,15,41,41,1
0,6,6,6,6,6,6,6,0
