9,5,5,5,5,5,5,5,10
2,32,32,32,32,32,32,32,1
2,14,13,12,12,13,13,15,1
2,18,30,17,27,11,11,19,1
2,41,41,41,18,11,11,19,1
2,41,41,41,41,18,25,19,1
2,41,41,41,41,41,20,19,1
2,41,41,41,41,41,18,16,1
0,6,6,6,6,6,6,6,0
