9,5,5,5,5,5,5,5,10
2,32,32,32,32,32,32,32,1
2,14,13,12,12,13,12,15,1
2,18,17,17,17,17,17,16,1
2,41,41,41,41,41,41,41,1
2,41,41,41,41,41,41,41,1
2,41,41,41,41,41,41,41,1
2,41,41,41,41,41,41,41,1
2,41,41,41,41,41,41,41,1
2,41,41,41,41,41,41,41,1
2,41,41,41,41,41,41,41,1
2,41,41,41,41,41,41,41,1
2,41,41,41,41,41,41,41,1
2,41,41,41,41,41,41,41,1
2,41,41,41,41,41,41,41,1
2,41,41,41,41,41,41,41,1
2,41,41,41,41,41,41,41,1
0,6,6,6,6,6,6,6,0
