9,5,5,5,5,5,5,5,10
2,32,32,32,32,32,32,32,1
2,41,41,41,41,41,41,41,1
2,41,41,41,41,41,41,41,1
2,41,14,15,41,14,15,41,1
2,41,20,19,41,20,19,41,1
2,41,18,16,41,18,16,41,1
2,41,41,41,41,41,41,41,1
2,41,41,41,41,41,41,41,1
2,41,14,15,41,14,15,41,1
2,41,20,19,41,20,19,41,1
2,41,18,16,41,18,16,41,1
2,41,41,41,41,41,41,41,1
2,41,41,41,41,41,41,41,1
0,6,6,6,6,6,6,6,0
