9,5,5,5,5,5,5,5,10
2,32,32,32,32,32,32,32,1
2,41,41,41,41,41,41,41,1
2,41,41,41,41,41,41,14,1
2,41,41,41,41,41,14,22,1
2,41,41,41,41,14,22,11,1
2,41,41,41,14,22,11,11,1
2,41,41,14,22,11,11,11,1
0,6,6,6,6,6,6,6,0
