9,5,5,5,5,5,5,5,5,5,5,5,5,5,5,5,5,5,10
2,32,32,32,32,32,32,32,32,32,32,32,32,32,32,32,32,32,1
2,41,41,41,41,41,41,41,41,41,41,41,41,41,41,41,41,41,1
2,41,41,41,41,41,41,41,41,41,41,41,41,41,41,41,41,41,1
2,41,41,41,41,41,41,41,41,41,41,41,41,41,41,41,41,41,1
2,41,41,41,41,41,41,41,41,41,41,41,41,41,41,41,41,41,1
2,41,41,41,41,41,41,41,41,41,41,41,41,41,41,41,41,41,1
2,41,41,41,41,41,41,41,41,41,41,41,41,41,41,41,41,41,1
2,41,41,41,41,41,41,41,41,41,41,41,41,41,41,41,41,41,1
2,41,41,41,41,41,41,41,41,41,41,41,41,41,41,41,41,41,1
2,41,41,41,41,41,41,41,41,41,41,41,41,41,41,41,41,41,1
2,41,41,41,41,41,41,41,41,40,41,41,41,41,41,41,41,41,1
2,41,41,41,41,41,41,41,41,41,41,41,41,41,41,41,41,41,1
2,41,41,41,41,41,41,41,41,41,41,41,41,41,41,41,41,41,1
2,41,41,41,41,41,41,41,41,41,41,41,41,41,41,41,41,41,1
2,41,41,41,41,41,41,41,41,41,41,41,41,41,41,41,41,41,1
2,41,41,41,41,41,41,41,41,41,41,41,41,41,41,41,41,41,1
2,41,41,41,41,41,41,41,41,41,41,41,41,41,41,41,41,41,1
2,41,41,41,41,41,41,41,41,41,41,41,41,41,41,41,41,41,1
0,6,6,6,6,6,6,6,6,6,6,6,6,6,6,6,6,6,0
